"StageID","MachineID"
"0","0"
"0","1"
"0","2"
"0","3"
"1","4"
"1","5"
"1","6"
"2","7"
"2","8"
"2","9"
"2","10"
"2","11"
"3","12"
"3","13"
"3","14"
"3","15"
"3","16"
"4","17"
"4","18"
"4","19"
"5","20"
"5","21"
"5","22"
"5","23"
"5","24"
"6","25"
"6","26"
"6","27"
"6","28"
