"StageID","MachineID"
"0","0"
"0","1"
"0","2"
"0","3"
"0","4"
"1","5"
"1","6"
"1","7"
"1","8"
"1","9"
"2","10"
"2","11"
"2","12"
"3","13"
"3","14"
"3","15"
"4","16"
"4","17"
"4","18"
"5","19"
"5","20"
"5","21"
"5","22"
"6","23"
"6","24"
"6","25"
"6","26"
"6","27"
