"StageID","MachineID"
"0","0"
"0","1"
"0","2"
"0","3"
"0","4"
"1","5"
"1","6"
"1","7"
"1","8"
"1","9"
"2","10"
"2","11"
"2","12"
"3","13"
"3","14"
"3","15"
"3","16"
"4","17"
"4","18"
"4","19"
"4","20"
"4","21"
"5","22"
"5","23"
"5","24"
"5","25"
"5","26"
"6","27"
"6","28"
"6","29"
"6","30"
